tidakkalau : tidak kalau
selama2nya : selama-lamanya
caiesisanya : cair sisanya
patihan : pelatihan
smk : SMK
dsn : dan
mangkanya : makanya
bpibu : bapak ibu
woy : hei
gajelas : tidak jelas
akal2an : akal-akalan
kemna : ke mana
ecek2 : ecek-ecek
ngkikutin : mengikuti
wkwkww : haha
pakminta : pak, minta
lonfry : laundry
dam : dan
membelk : membeli
dhulu : dahulu
pnjoki : penjoki
ampasss : ampas
hangusjadi : hangus jadi
flatfome : platform
bapaibu : bapak ibu
inijgn : ini jangan
pemudawoy : pemuda
amin : amin
pakdhe : pakde
nilep : mengambil
negararakyat : negara rakyat
biasamantap : biasa mantap
sertifikay : sertifikat
pra kerja : prakerja
peengurus : pengurus
pakterimakasih : pak terima kasih
sakarepmu : terserah kamu
sehari2 : sehari-hari
pllatihan : pelatihan
mngikuti : mengikuti
blki : BLK
di skip : dilewati
jabut : cabut
bidamg : bidang
hargaharga : harga-harga
alokasiin : alokasikan
wooooeeelatihan : latihan
inj : ini
gubrakkkk : jatuh